------***
-p----*--
----*-#a-
---------
---------