---**------
-a---------
--------a--
-----p-----
-#------**-
a#---------