------***
-a-#-----
---#-a--p
-#------c
k#----***