##----#***
a#-m--#a-*
-#--#--#a*
-#--#----#
---k#--c-#
p------###