--m---m--
k#-#-#---
-#-#p#---
--------c
****#####