#-####--------##
#-###--###-##-##
#-----##-#-##-##
#-###----#-##-##
#-###########-##
#------p---#---#
##########-#-#-#
##a---#----#-#--
c####---####-##-
------###k---#-a